**************
*    *       *
* *  * * *****
* *  * * *   *
* *    * * ***
* ******     *
** *G     *   *
*S************
