**************
*    *       *
* *  * * *****
* *  * * *   *
* *    * * ***
* ******     *
* *G     *   *
*S************
