**********
S   **   *
*** *  ***
*   ** * G
* **** * *
*        *
**********
